11
10
++++++++++
+       ++
>  ++    +
+  ++ ++ +
+  +++   +
+    +   +
+  +     X
+  +++++ +
+        +
++++++++++
++++++++++