10
10
 ++++++++ 
+>+     ++
+ +      +
+ +      +
+ +      +
+ +++    +
+    +   X
+  +++++ +
+        +
++++++++++